30 seconds=30 secondes
1 minute=1 minute
2 minutes=2 minutes
5 minutes=5 minutes
10 minutes=10 minutes
30 minutes=30 minutes
1 hour=1 heure
2 hours=2 heures
Above=Au dessus
Array must be Started to view disk stats=L'Array doit être **Démarrée** pour afficher les statistiques du disque
Array must be Started to view system stats=L'Array doit être **Démarrée** pour afficher les statistiques du système
Available for Data=Disponible pour les données
Below=Au dessous de
CPU Load=Charge CPU
Disk Usage=Utilisation du disque
disks=disques
High on Usage=Utilisation élevée
Last day=Dernier jour
Last 2 days=2 derniers jours
Last 3 days=3 derniers jours
Last week=Semaine dernière
Last 2 weeks=2 dernières semaines
Last 3 weeks=3 dernières semaines
Last month=Mois dernier
Low on Space=Peu d'espace
Normal Usage=Utilisation normale
Real-time=Temps réel
Since start=Depuis le début
Storage=Stockage
Total Array Size=Taille totale Array
Total Space Used=Espace total utilisé
Used for Parity=Utilisé pour la parité
utilization in percentage=utilisation en pourcentage
