Automatic theming=Thématique automatique
Bing API key=Clé API Bing
Bing=Bing
City name=Nom de la ville
Country name=Nom du pays
Day theme=Thème jour
Geocoding service=Service de géocodage
Google API key=Clé API Google
Google=Google
MapQuest API key=Clé API MapQuest
MapQuest=MapQuest
Night theme=Thème nuit
No geographical coordinates found for the given address=Aucune coordonnée géographique trouvée pour l'adresse donnée
Please adjust=Veuillez ajuster
Postal code=Code postal
See=Voir
Street address=Adresse de la rue
this site=ce site
to obtain a Bing API key=pour obtenir une clé API Bing
to obtain a Google API key=pour obtenir une clé API Google
to obtain a MapQuest API key=pour obtenir une clé API MapQuest

:day_night_plug:
> Entrez vos informations d'adresse (rue, ville, pays) qui sont utilisées pour calculer les heures de lever et de coucher du soleil de votre emplacement.
>
> Un service de géocodage est utilisé pour convertir votre adresse en coordonnées géographiques (latitude et longitude).<br>
> Vous devez vous inscrire à l'un des services disponibles et obtenir une clé API unique pour utiliser leur service.
>
> Le thème **jour** est sélectionné entre le lever et le coucher du soleil<br>
> Le thème **nuit** est sélectionné entre le coucher et le lever du soleil
:end
